1111111111
1000000001
1000000001
1003223001
1002222001
1002222001
1003223001
1000000001
1000000001
1111111111